6
1 0 0 1 1 0
0 1 1 0 1 0
0 1 1 1 1 0
1 0 1 1 1 0
1 1 1 1 1 0
0 0 0 0 0 1
5
12.2
0
0.3
6.
2.4